NO ./north
SO ./south
WE ./west
EA ./east

F 220,100,0
C 173, 216, 230

111111111111111111111111111111111
101111111111111111111111111111111
100111111111111111111111111111111
100011111111111111111111111111111
100001111111111111111111111111111
100000111111111111111111111111111
100000011111111111111111111111111
100000W01111111111111111111111111
100000011111111111111111111
100000111111111111111111111111111
100001111111111111111111111111111
11111111111111111111111111111
