NO ./textures/north/nt.xpm
SO ./textures/south/st.xpm
WE ./textures/west/wt.xpm
EA ./textures/east/et.xpm

F 220,100,0
C 173, 216, 230

       1111111111111111111111111
       1000000000110000000000001
       1011000001110000000000001
       1001000000000000000000001
11111111101100000111000000000001
100000000011000001110111111111111111111
1111011111111101110000001E0000000000001
111101111111110111010100000000000000001
110000001101010111000000100000000000001
100000000000000000000000100000000000001
100000000000000011010100100000000000001
11000001110101011111011110011111111111
11110111 1110101 100011010001
11111111 1111111 111111111111
