NO ./north
SO ./south
WE ./west
EA ./east

F 220,100,0
C 225,30,0

111111111111111111111111111111111
111111111000000001100000000000001
111111111011000001110000000000001
111111111001000000000000000000001
111111111011000001110000000000001
100000000011000001110111111111111
111101111111110111000000100011111
111101111111110111010100100011111
110001S11111110111000000100011111
100000001000100011000000100011111
100000001111100011010100100011111
11000001 101010111110111100011111
11110111 1110101 1011110100011111
11111111 1111111 1111111111111111
