NO ./north
SO ./south
WE ./west
EA ./east

F 220,100,0
C 225,30,0

111111111111111111111111111111111
101111111111111111111111111111111
100111111111111111111111111111111
100011111111111111111111111111111
100001111111111111111111111111111
100000111111111111111111111111111
100000011111111111111111111111111
100000N01111111111111111111111111
100000011111111111111111111111111
100000111111111111111111111111111
100001111111111111111111111111111
111111111111111111111111111111111
